111111111111111111111111
100000200000000004000001
101100000222000300004001
100003000330022000300001
102220200000211003000401
100000400220200000040001
103032004200200040000401
100300000000000403000001
103000200003003300003301
103004330300033000023001
100003034230001100000001
104030000300200000000201
100000400000330030002201
100400004000022222222001
120000004040000000000001
111111111111111111111111