111111111111111111111111
100000200000000004000001
102200000222000300004001
100300011111202200030001
102200000000204003000401
100000400220200000040001
102300200200208400400001
100300200400000000000001
103000040403003300003301
103000330300033030023001
100003030030010000000001
104330000300200000000201
100000401000220000002201
100400004000022222222001
100000000204000000000001
111111111111111111111111