111111111111111111111111
100000200000000004000001
102200000222000300004001
100000000002200030000001
102200100000204003000401
100000400220200000340001
103033420020020004000041
100300200000040000000001
103000000030033000033001
103000330300033000023001
100003230030000100000001
104030000300220000000021
100000400000220000002201
100401022400002332422201
100000000040000000000001
111111111111111111111111