111111111111111111111111
100000200000000004000001
102200000222000300004001
100000003300220003000001
102200000000204003000401
100000400220200000040001
103002200330020004000041
100300200000000000000001
103004000430033000033001
103000303000330000230001
100004030030000000000001
104030000300200000000201
100003304000002200000021
100400004000022222222001
100000000040000000000001
111111111111111111111111