111111111111111111111111
100000200000000004000001
102200000222000300004001
100000000002200030000001
102200000000204003000401
100000400220200000040001
103000200200200040000401
100300200000000000000001
103000000030033000033001
103000330300033000023001
100003030030000000000001
104030000300200000000201
100000400000220000002201
100400004000022222222001
100000000040000000000001
111111111111111111111111